     C                             153,204,255
         F 164,  169     ,20
            NO ./textures/eagle.xpm
        WE              ./textures/redbrick.xpm
    EA                        ./textures/baysal.xpm
SO                                 ./textures/wood.xpm



1111111111111111 
1000000000000001 
1000000010000001 
1000000100N00001
1000000010000001 
1011111110000001 
1000000000000001 
1111111111111111 
