            NO       ./textures/eagle.xpm
        WE              ./textures/redbrick.xpm
    EA                        ./textures/baysal.xpm
SO                                 ./textures/wood.xpm


         F                  164,169,20
     C                             153,204,255

111
111
111
101
101
101
101
101
101
101
101
101
1011111111111111111111111111111111111111111111111111
1S00000000000000000000000000000000000000000000000001
1111111111111111111111111111111111111111111111111111






