F 200,12,32
NO ./path
C 255,255,0
WE .path
SO .path
E .path

     11111111111111111111                          
     10000110000000000001                          
1111110000110000000000001                          
100000000011000010000000111111111111111111111111   
100000000011000000000000000000000000000000000001111
100000000000000000E00000000000000000000000000000001
100000000011000000000000000000000000000000000001111
100000000011000000011111111111111111111111111111   
10000000001100000001                               
11111101111110111111                               
1000000000010000000111111                          
1000000000010000000000001                          
1000000000000000000000001                          
1111111111111111111111111                          
